एक	a
कुत्ता	dog
दो	two
कुत्ते	dogs
को	a
लगा	a
लड़की	girl
बच्ची	girl
तीन	three
काला	black
सफेद	white
लड़की	girl
लड़का	boy
घूम	the
चला	a
इस	a
चार	four
झूल	swing
झूल	a
काले	black
ek	a
झूला	on
चलता	the
उड़	the
उड़	water
बिस्तर	bed
लड़किया	girls
बाधा	over
बॉल	ball
बेंच	bench
वाली	a
बर्फीली	in
पट्टी	down
टायर	tire
पत्थर	a
युवक	man
स्नान	in
गिटार	guitar
तैरता	water
कुता	dog
जाता	the
हॉकी	hockey
यह	a
आग	jumping
kutta	dog
बल	on
उलटी	a
टेनिस	tennis
घोड़ा	horse
वहां	a
स्कूटर	scooter
se	a
गोता	into
उथले	dog
बाधाओं	over
नाक	nose
झूलता	a
रोप	is
दौड़ते	the
सोफे	couch
लोट	in
फरमा	in
नारंगी	a
जैकेट	jacket
फव्वारे	playing
फिसलते	down
हैट	hat
सिगरेट	cigarette
गुलाबी	girl
pool	into
दिखता	the
बेच	fruit
गिलहरी	squirrel
डॉलफिन	dolphin
घोडा	horse
किक	a
कलाकार	man
